2 2 3 2 2 2 2 2 2 2 2 2 2 2 8 31 30 16 16 16 30 31 7 2 2 2 2 2 2 3 2 2 2 2 2 2 2 
2 2 2 2 2 2 2 2 2 2 2 2 2 2 8 1 30 16 16 16 30 31 7 2 2 2 2 2 2 2 2 3 2 2 2 2 2 
2 2 2 2 3 2 2 2 2 2 2 2 2 2 8 31 30 16 16 16 30 1 7 2 2 2 2 2 2 2 2 2 2 2 2 2 2 
2 2 2 2 3 2 2 2 2 2 3 3 2 2 8 31 30 16 16 16 30 31 7 2 2 2 2 2 2 2 2 2 2 3 2 2 2 
2 3 3 2 2 3 3 2 2 2 2 3 2 2 8 1 30 16 16 16 30 31 7 2 2 3 2 2 2 3 3 2 2 2 2 2 3 
2 2 2 2 2 2 3 3 2 2 2 2 2 2 8 1 30 16 16 16 30 31 7 2 2 2 2 2 2 2 2 2 2 2 2 2 2 
2 2 2 2 2 2 2 2 2 2 2 2 2 2 8 31 30 16 16 16 30 1 7 2 2 2 2 2 2 2 2 2 2 2 2 2 2 
2 2 2 2 2 2 2 2 2 2 2 2 2 2 8 31 30 16 16 16 30 31 7 2 2 2 2 2 2 2 2 2 2 3 2 2 2 
2 2 2 2 2 2 2 2 2 2 2 3 2 2 8 1 30 16 16 16 30 31 7 2 2 2 2 2 2 2 2 2 2 3 3 2 2 
2 2 2 3 2 2 2 2 3 2 2 2 2 2 8 31 30 16 16 16 30 1 7 2 2 2 3 3 2 3 2 2 2 2 2 2 3 
2 2 2 2 3 2 2 2 2 2 2 2 2 2 8 31 30 16 16 16 30 31 7 2 2 3 2 2 2 2 2 2 2 2 2 2 2 
2 2 2 2 2 2 2 3 3 2 2 2 2 2 8 31 30 16 16 16 30 1 7 2 2 2 2 2 2 2 2 2 3 3 2 2 2 
2 2 2 2 2 2 2 2 2 2 2 2 2 2 8 1 30 16 16 16 30 31 7 2 2 2 2 2 3 2 2 2 2 3 2 2 2 
2 2 2 2 2 2 2 2 2 2 3 3 2 2 8 31 30 16 16 16 30 31 7 2 2 3 2 2 2 2 2 3 2 2 2 2 2 
2 2 3 2 2 2 2 2 2 2 2 2 2 2 8 1 30 16 16 16 30 1 7 2 2 2 3 2 2 2 2 2 2 2 3 2 2 
2 2 2 2 2 2 2 3 3 2 2 2 2 2 8 31 30 16 16 16 30 31 7 2 2 2 2 3 2 2 2 2 2 2 2 2 2 
2 2 2 2 2 2 2 2 2 2 2 2 2 2 8 31 30 16 16 16 30 31 7 2 2 2 2 2 2 2 2 2 2 2 2 2 2 
2 2 3 3 2 3 2 2 2 2 2 3 2 2 8 31 30 16 16 16 30 31 7 2 2 2 2 2 2 2 2 3 2 2 2 2 2 
2 2 2 2 2 3 2 2 2 3 3 3 2 2 8 1 30 16 16 16 30 1 7 2 2 2 2 2 2 2 2 2 2 2 2 2 2 
2 2 2 2 2 2 2 2 2 2 2 3 2 2 8 1 30 16 16 16 30 31 7 2 2 2 2 2 2 3 2 2 2 2 2 2 2 
2 2 2 2 2 3 2 2 2 2 2 2 2 2 8 31 30 16 16 16 30 31 7 2 2 2 2 2 2 2 2 2 2 2 2 2 3 
2 2 2 2 2 3 2 2 2 2 2 2 2 2 8 31 30 16 16 16 30 31 7 2 3 3 2 2 2 3 2 2 3 3 3 3 3 
2 2 3 2 2 2 2 2 2 3 2 2 2 2 8 1 30 16 16 16 30 31 7 2 2 2 2 2 2 2 2 2 2 2 2 2 2 
2 2 2 2 2 2 2 2 2 2 2 2 2 2 8 31 30 16 16 16 30 1 7 2 2 2 3 2 2 2 2 2 2 2 2 2 2 
2 2 2 2 2 2 2 2 2 2 2 2 2 2 8 1 30 16 16 16 30 31 7 2 2 2 2 2 2 2 2 2 2 2 2 2 2 
2 2 2 3 2 2 3 2 2 2 2 2 2 2 8 31 30 16 16 16 30 31 7 2 2 2 2 2 2 2 2 2 2 3 2 2 2 
2 2 2 2 2 2 2 2 2 2 2 2 2 2 8 31 30 16 16 16 30 0 7 2 2 2 2 2 2 2 2 2 2 2 2 2 2 
2 2 2 2 2 2 2 3 2 2 2 3 2 2 8 1 30 16 16 16 30 31 7 2 2 3 2 2 2 2 2 2 2 2 3 3 2 
2 2 2 2 3 2 2 2 2 2 2 2 2 2 8 31 30 16 16 16 30 31 7 2 2 2 2 3 2 2 2 2 2 3 3 2 2 
2 2 2 2 2 2 2 3 2 2 2 2 2 2 8 31 30 16 16 16 30 31 7 2 2 2 2 2 2 2 2 2 2 2 2 2 2 
2 2 2 2 2 2 2 2 2 2 2 2 2 2 8 31 30 16 16 16 30 1 7 2 2 2 2 2 2 2 2 2 2 2 2 2 2 
2 2 3 2 2 2 2 2 2 2 3 2 2 2 8 1 30 16 16 16 30 31 7 2 2 2 2 2 2 2 2 2 2 2 3 2 3 
