31 31 31 31 31 31 31 31 31 31 31 31 31 0 31 31 31 31 31 31 31 0 31 31 0 31 31 0 31 31 31 0 31 0 31 0 31 31 31 31 31 31 31 1 31 31 0 31 
31 31 1 31 1 31 31 1 1 31 31 0 31 31 31 31 31 31 31 0 0 31 1 31 31 0 0 31 31 31 0 31 31 31 0 31 31 1 31 31 1 31 31 31 0 31 31 31 
31 0 31 0 31 1 31 31 1 31 31 1 31 31 31 0 31 0 31 0 31 31 31 1 31 31 31 31 31 31 31 0 0 31 31 31 31 31 0 31 31 1 31 31 0 31 1 31 
31 31 31 31 31 31 31 31 31 31 31 31 31 1 31 31 31 31 31 31 31 31 31 31 31 31 31 0 31 0 31 31 1 31 31 1 0 31 31 31 31 31 1 1 31 31 31 31 
0 31 31 1 31 31 0 0 0 0 31 1 31 31 0 31 31 31 1 31 1 31 31 0 31 0 31 31 31 31 31 31 31 31 31 31 31 31 31 31 0 31 1 31 25 23 23 23 
0 0 31 31 31 31 31 31 31 31 31 31 1 31 31 31 31 31 31 31 31 31 31 31 31 31 31 31 31 31 1 25 23 23 26 25 23 23 26 1 25 23 23 23 24 16 16 16 
31 31 1 31 31 31 0 0 31 31 31 31 31 31 31 31 1 31 31 31 31 31 31 31 31 31 31 31 25 23 23 24 16 16 22 24 16 16 22 23 24 16 16 16 16 16 16 16 
31 1 31 31 31 31 31 31 31 31 0 1 1 1 25 23 23 26 25 23 23 26 25 23 23 23 23 23 24 16 16 16 16 16 16 16 16 16 16 16 16 16 16 16 16 16 16 16 
31 31 31 0 31 31 25 23 23 23 23 23 23 23 24 16 16 22 24 16 16 22 24 16 16 16 16 16 16 16 16 16 16 16 16 16 16 16 16 16 16 16 16 16 16 16 17 18 
23 23 23 23 23 23 24 16 16 16 16 16 16 16 16 16 16 16 16 16 16 16 16 16 16 16 16 16 16 16 16 16 16 17 18 19 16 17 18 18 18 18 18 18 18 18 1 31 
16 16 16 16 16 16 16 16 16 16 16 16 16 16 16 16 16 16 16 16 16 16 16 16 16 16 16 16 16 16 17 18 18 0 0 27 18 28 0 31 0 1 31 31 31 0 31 0 
16 16 16 16 16 16 16 16 16 16 16 16 16 16 17 18 18 18 18 18 18 18 18 18 18 18 18 18 18 18 28 31 31 0 31 0 31 31 0 31 0 31 31 31 31 31 31 31 
16 16 16 16 16 16 17 18 18 18 18 18 18 18 28 0 0 1 0 0 0 0 0 1 0 0 0 1 0 0 31 0 31 0 31 31 31 31 31 0 31 31 0 0 31 31 31 0 
18 18 18 18 18 18 28 31 31 31 0 1 1 1 0 0 0 31 31 0 31 0 31 0 0 31 0 31 31 31 0 0 31 0 31 0 31 0 0 31 1 0 31 0 0 31 0 31 
0 31 1 31 0 31 31 31 31 0 31 1 1 31 31 1 31 31 31 31 0 0 1 31 31 31 31 31 31 0 31 31 31 31 31 31 0 31 31 0 31 31 31 31 31 31 31 31 
31 31 31 31 31 31 0 0 0 0 31 31 0 31 31 31 1 31 31 31 31 31 31 31 0 31 31 31 0 31 31 31 31 31 31 0 31 31 0 31 31 31 1 31 31 0 31 31 
0 31 1 0 0 31 0 31 0 31 31 0 31 31 31 31 31 31 31 31 31 31 0 31 31 31 31 31 31 31 0 31 1 31 0 31 31 31 31 31 31 1 31 31 31 31 31 31 
31 31 31 31 31 31 31 31 1 31 31 31 31 1 31 31 0 31 31 31 31 0 31 0 31 31 31 1 31 1 31 31 31 1 31 31 31 1 31 31 0 31 31 0 31 31 0 0 
31 1 31 1 31 31 31 0 31 31 1 31 31 31 31 31 31 1 31 31 31 31 31 31 31 1 31 31 1 31 1 31 31 31 31 0 31 31 31 31 1 31 31 31 1 31 31 31 
