2 2 2 2 2 2 2 2 2 2 2 2 2 2 2 2 2 2 2 2 2 2 8 31 30 30 16 30 30 31 7 2 2 2 2 2 2 2 2 2 2 2 2 2 2 2 2 2 2 2 
2 2 2 2 2 2 2 2 2 2 2 2 2 2 2 2 2 3 2 2 2 2 14 6 21 16 16 16 20 31 7 2 2 2 2 2 2 2 2 2 2 2 2 2 2 3 3 2 2 2 
2 2 2 2 2 2 2 2 2 2 2 2 2 2 2 2 2 2 2 2 2 2 2 8 21 16 16 16 20 4 15 2 2 3 3 3 2 2 2 2 2 2 2 2 2 2 2 2 2 2 
2 2 2 2 2 3 3 2 2 2 2 3 2 3 2 2 2 2 2 2 2 2 2 8 21 16 16 16 20 7 2 2 2 2 2 2 2 2 2 2 2 2 2 2 2 2 2 2 2 2 
2 2 2 2 2 2 2 2 2 2 2 2 2 2 2 2 2 2 2 2 2 2 2 8 21 16 16 16 20 7 2 2 2 2 2 2 2 2 2 2 2 2 2 2 2 2 2 2 2 2 
3 2 2 2 2 2 2 3 2 2 2 2 2 2 2 2 2 2 2 2 2 2 2 8 21 16 16 16 20 7 2 2 2 2 2 2 2 2 2 2 3 3 2 2 2 2 2 2 2 2 
2 2 2 2 2 2 2 2 2 2 2 2 3 2 2 2 2 2 2 2 2 2 2 8 21 16 16 16 20 9 10 10 10 13 2 2 2 2 2 2 2 2 2 2 2 2 2 2 2 2 
2 2 2 3 2 2 2 2 2 2 2 2 2 2 2 2 2 12 10 10 10 10 10 11 21 16 16 16 20 31 31 31 31 9 10 10 13 2 2 2 2 2 2 2 2 2 2 2 2 2 
2 2 2 2 2 2 2 2 2 2 2 2 2 2 2 2 12 11 0 1 1 31 31 31 21 16 16 16 20 31 1 31 31 1 1 1 9 10 10 10 10 10 10 13 2 2 2 2 2 3 
2 2 2 2 2 2 2 3 2 2 2 2 2 12 10 10 11 1 1 31 31 31 31 0 21 16 16 16 20 31 31 1 31 31 1 1 0 31 1 1 1 1 1 9 10 10 10 10 10 10 
2 2 2 2 2 2 2 2 2 2 2 2 12 11 1 31 1 1 31 31 31 31 31 1 21 16 16 16 20 31 1 31 31 31 31 31 31 0 31 31 31 31 31 31 1 31 1 1 31 1 
3 2 3 3 3 2 2 2 2 2 12 10 11 31 1 31 31 31 1 31 0 31 31 0 21 16 16 16 20 31 31 31 31 31 1 31 31 0 31 31 0 31 0 31 31 31 31 31 1 31 
3 2 2 2 2 2 2 2 2 12 11 0 31 31 1 1 1 0 0 31 31 31 31 0 21 16 16 16 20 31 31 1 31 1 1 31 31 31 31 0 31 0 31 31 31 1 31 31 31 31 
2 2 2 2 2 2 2 2 12 11 0 31 31 31 1 31 31 31 1 0 0 0 1 31 21 16 16 16 20 31 1 1 31 0 31 1 31 0 31 1 31 0 31 0 31 0 0 31 1 0 
2 2 2 2 2 2 2 2 8 0 31 31 31 1 1 1 1 0 0 31 1 31 0 31 21 16 16 16 20 31 31 31 31 0 31 1 31 31 31 0 31 0 31 0 31 0 31 0 31 31 
2 2 3 3 2 2 2 12 11 31 1 1 1 1 31 31 1 31 0 31 0 31 0 31 21 16 16 16 20 31 31 31 31 31 31 1 1 1 31 1 31 0 0 31 0 31 31 31 31 1 
2 2 2 2 3 2 12 11 31 31 1 31 1 1 31 31 1 31 0 0 0 1 0 31 21 16 16 16 20 1 31 31 31 0 31 31 31 31 31 31 31 31 0 1 31 1 0 31 1 31 
2 2 2 2 2 12 11 1 31 31 1 1 1 31 31 31 1 31 31 31 0 31 0 31 21 16 16 16 20 1 31 31 1 1 31 31 1 31 1 1 31 31 31 31 0 31 1 31 31 1 
2 2 3 2 2 8 31 31 1 31 1 1 31 31 0 0 1 1 1 31 0 31 0 31 21 16 16 16 20 1 31 31 1 31 31 0 31 0 31 31 31 0 31 1 0 1 31 1 31 31 
2 3 2 3 2 8 31 31 31 31 1 31 1 31 0 31 31 31 1 1 31 1 31 31 21 16 16 16 20 1 31 31 1 31 31 1 0 31 31 1 31 31 31 1 0 31 31 0 31 1 
2 2 2 2 12 11 0 31 0 31 1 31 1 31 0 31 31 31 31 31 31 31 25 23 24 16 16 16 22 23 26 31 31 31 31 31 31 0 31 1 1 1 31 31 31 31 31 31 31 1 
2 2 2 12 11 0 31 31 31 31 1 31 0 31 31 1 31 1 1 31 1 31 21 16 16 16 16 16 16 16 20 31 31 1 31 31 31 31 31 31 31 1 31 31 1 1 31 1 1 31 
2 2 2 8 0 31 0 31 0 0 0 0 0 0 0 0 0 0 0 0 0 0 21 16 17 18 18 18 19 16 22 23 23 23 23 23 23 23 23 23 23 23 23 23 23 23 23 23 23 23 
2 3 2 8 0 31 31 0 31 31 0 31 0 0 31 31 0 31 0 0 0 0 21 16 20 4 5 6 21 16 16 16 16 16 16 16 16 16 16 16 16 16 16 16 16 16 16 16 16 16 
2 3 2 8 0 0 0 31 0 31 31 0 0 0 0 31 0 31 0 31 31 0 21 16 20 7 3 8 21 16 16 16 16 16 16 16 16 16 16 16 16 16 16 16 16 16 16 16 16 16 
2 3 3 8 0 31 31 0 0 31 31 31 31 0 31 0 31 0 0 31 0 31 21 16 20 9 10 11 21 16 16 16 16 16 16 16 16 16 16 16 16 16 16 16 16 16 16 16 16 16 
2 3 3 8 31 0 31 31 31 0 0 0 0 0 31 31 0 31 0 0 31 31 21 16 22 23 23 23 24 16 17 18 18 18 18 18 18 18 18 18 18 18 18 18 18 18 18 18 18 18 
2 2 2 8 0 31 1 1 31 0 31 31 1 31 31 1 31 1 31 31 31 31 21 16 16 16 16 16 16 16 20 31 0 31 31 0 0 0 0 0 31 0 31 31 31 31 31 1 31 1 
2 2 2 8 0 31 0 31 31 31 31 31 1 0 31 31 0 31 31 1 31 31 27 18 19 16 16 16 17 18 28 31 31 31 31 31 0 31 31 31 31 0 31 31 31 31 1 31 31 31 
3 2 2 14 6 31 31 0 1 31 31 0 1 31 31 31 31 0 31 1 31 1 31 31 21 16 16 16 20 0 31 31 31 0 31 31 31 31 31 31 31 31 31 0 31 31 31 31 31 1 
2 2 2 2 8 31 31 31 1 31 1 31 1 31 31 1 31 1 31 1 31 1 31 31 21 16 16 16 20 0 31 31 31 31 1 1 31 0 31 0 0 31 31 31 0 31 31 1 31 31 
2 2 2 2 8 31 0 31 31 31 31 31 1 31 31 31 31 31 0 31 0 1 31 31 21 16 16 16 20 0 31 31 0 0 31 31 31 31 1 31 31 0 0 31 0 1 0 31 31 31 
2 3 3 2 8 0 31 1 1 0 1 1 1 0 0 31 0 31 31 0 31 1 31 31 21 16 16 16 20 0 31 31 31 31 31 0 31 31 0 31 31 31 31 0 31 31 1 31 0 0 
2 2 2 2 14 5 6 1 31 1 31 0 0 31 0 31 31 1 0 31 31 1 0 31 21 16 16 16 20 31 31 0 31 31 31 0 31 1 1 31 31 0 31 31 31 0 31 31 0 31 
2 2 2 2 2 2 8 1 1 1 31 0 31 31 0 0 31 31 31 31 31 1 31 31 21 16 16 16 20 31 31 31 1 1 31 31 31 31 0 31 31 31 31 31 0 31 31 1 31 31 
2 2 2 2 2 2 14 6 1 1 31 0 0 31 0 0 0 31 31 31 0 1 0 31 21 16 16 16 20 31 31 31 0 31 0 31 0 31 31 0 0 0 31 0 1 0 31 31 31 31 
2 2 2 2 2 2 2 14 6 1 1 31 0 0 31 31 31 0 31 31 31 1 31 31 21 16 16 16 20 31 31 1 31 31 31 0 0 31 31 0 31 31 0 31 31 31 31 31 1 1 
3 2 2 2 2 2 2 2 8 1 1 31 31 0 0 0 0 31 31 0 31 1 0 31 21 16 16 16 20 31 31 31 31 31 31 31 31 0 31 31 31 1 0 31 31 31 1 1 1 1 
3 2 2 2 2 2 2 2 14 6 1 1 1 31 31 31 0 31 31 31 31 1 31 31 21 16 16 16 20 31 31 31 0 0 31 0 0 31 31 31 31 31 1 1 1 1 1 1 4 5 
2 2 3 3 2 2 2 2 2 14 5 6 1 1 31 31 0 0 0 0 31 1 31 31 21 16 16 16 20 31 31 1 31 31 1 1 31 31 31 0 0 1 1 1 1 4 5 5 15 2 
2 2 2 2 2 2 2 2 2 2 2 14 6 1 1 31 31 31 31 31 31 1 31 1 21 16 16 16 20 0 31 31 1 31 31 31 31 31 0 0 4 5 5 5 5 15 2 2 2 2 
2 2 2 2 2 2 2 2 2 2 2 2 14 6 1 1 31 31 31 1 1 1 31 31 21 16 16 16 20 31 31 31 31 31 31 31 0 0 4 5 15 2 2 2 2 2 2 2 2 2 
2 2 2 2 2 2 2 2 2 2 2 2 2 14 6 1 1 1 1 1 31 31 31 31 21 16 16 16 20 31 1 31 0 0 0 4 5 5 15 2 2 2 2 2 2 2 2 2 2 2 
2 2 2 3 2 2 2 2 2 2 2 2 2 2 14 5 5 5 5 5 6 31 0 31 21 16 16 16 20 31 31 31 4 5 5 15 2 2 2 2 2 2 2 2 2 3 2 2 2 2 
2 2 2 2 2 2 2 2 2 2 3 2 2 2 2 2 2 2 2 2 14 5 6 31 21 16 16 16 20 31 4 5 15 2 2 2 2 2 2 2 2 2 2 2 2 2 2 2 2 2 
2 2 2 2 2 2 2 2 2 2 2 2 2 2 2 2 2 2 2 2 2 2 8 31 21 16 16 16 20 31 7 2 2 2 2 2 2 2 2 2 2 2 2 2 2 2 2 2 2 2 
2 2 2 2 2 2 2 2 2 2 2 2 2 2 2 2 2 2 2 2 2 2 8 31 21 16 16 16 20 31 7 2 2 2 2 2 2 2 2 2 2 2 2 2 2 2 2 2 2 2 
2 2 2 2 2 2 2 2 2 2 2 2 2 2 2 2 2 2 2 2 2 2 8 31 21 16 16 16 20 31 7 2 2 2 2 2 2 2 2 2 2 2 2 2 2 2 2 2 2 2 
2 2 2 2 2 2 2 2 2 2 2 2 2 2 2 2 2 2 2 2 2 2 8 31 21 16 16 16 20 31 7 2 2 2 2 2 2 2 2 2 2 2 2 2 2 2 2 2 2 2 
2 2 2 2 2 2 2 2 2 2 2 2 2 2 2 2 2 2 2 2 2 2 8 31 21 16 16 16 20 31 7 2 2 2 2 2 2 2 2 2 2 2 2 2 2 2 2 2 2 2 
