2 2 3 2 2 2 2 2 2 3 3 12 10 10 11 31 21 16 16 16 20 31 9 10 10 10 13 2 3 3 2 2 2 3 2 2 3 
2 3 2 2 2 2 2 3 2 12 10 11 1 0 0 31 21 16 16 16 20 31 1 0 1 0 9 10 13 2 2 3 2 2 2 3 2 
3 2 2 2 3 12 10 10 10 11 31 31 1 1 0 31 21 16 16 16 20 31 0 1 0 31 31 0 9 10 13 3 2 3 2 2 3 
10 10 10 10 10 11 0 0 31 30 30 30 30 30 30 30 30 30 29 30 30 30 30 30 30 30 30 0 31 0 9 10 10 10 10 10 10 
0 0 0 0 31 31 0 31 31 30 29 29 29 29 29 29 29 29 29 29 29 29 29 29 29 29 30 31 31 31 31 0 0 0 0 0 0 
31 0 31 31 31 31 31 31 31 30 29 29 29 29 29 29 29 29 29 29 29 29 29 29 29 29 30 31 31 31 31 31 31 31 31 31 31 
31 31 31 31 1 31 31 31 31 30 29 29 29 29 29 29 29 29 29 29 29 29 29 29 29 29 30 31 31 31 31 31 0 31 31 31 31 
0 31 31 31 31 31 31 1 31 30 29 29 29 29 29 29 29 29 29 29 29 29 29 29 29 29 30 31 31 1 31 31 31 31 31 0 31 
31 31 31 31 31 0 31 31 31 30 29 29 29 29 29 29 29 29 29 29 29 29 29 29 29 29 30 31 31 31 31 0 31 31 31 31 31 
0 31 1 1 31 31 31 1 31 30 29 29 29 29 29 29 29 29 29 29 29 29 29 29 29 29 30 31 31 1 31 31 1 31 31 31 0 
31 31 31 1 31 31 31 31 31 30 29 29 29 29 29 29 29 29 29 29 29 29 29 29 29 29 30 31 31 31 31 31 31 31 31 0 31 
31 31 1 31 31 31 1 31 31 30 29 29 29 29 29 29 29 29 29 29 29 29 29 29 29 29 30 31 31 31 31 31 31 31 31 31 31 
31 31 31 31 31 0 0 31 31 30 30 30 30 30 30 30 30 30 29 30 30 30 30 30 30 30 30 31 31 1 31 0 31 31 31 31 0 
31 31 31 31 31 31 31 31 31 0 0 31 31 31 31 31 21 16 16 16 20 1 31 31 31 0 31 31 31 31 31 31 31 31 0 31 31 
31 31 31 0 31 31 1 31 31 31 1 31 31 31 31 1 21 16 16 16 20 1 0 31 31 31 31 31 31 31 31 31 31 31 0 1 31 
0 31 31 31 31 31 31 31 31 31 31 31 1 31 31 1 21 16 16 16 20 1 31 31 31 31 31 31 0 0 0 31 0 31 31 31 31 
31 0 31 31 31 31 1 1 31 31 31 31 31 31 1 1 21 16 16 16 20 1 0 31 31 31 31 31 0 31 31 31 31 0 31 31 31 
31 31 31 0 31 31 31 31 31 31 1 31 31 1 31 1 21 16 16 16 20 0 0 31 31 0 31 31 0 31 31 31 31 31 31 0 0 
31 31 31 31 31 31 1 31 31 31 31 31 1 31 31 1 21 16 16 16 20 0 31 0 31 31 31 31 31 31 1 31 31 31 0 31 31 
31 31 31 31 1 1 31 31 31 31 0 31 31 1 31 1 21 16 16 16 20 31 31 31 0 31 31 31 31 31 31 31 1 31 31 31 31 
0 0 0 31 31 31 1 31 31 31 0 31 0 31 31 31 21 16 16 16 20 31 31 31 0 31 31 31 0 31 31 31 31 1 31 1 31 
31 31 31 31 31 31 31 31 31 31 0 31 31 31 31 31 21 16 16 16 20 31 0 31 0 31 31 31 0 0 31 31 31 31 31 31 31 
31 31 31 31 31 31 1 31 31 31 31 31 31 0 31 31 21 16 16 16 20 31 31 31 31 31 31 31 0 31 31 31 31 31 31 31 31 
31 31 31 1 31 31 31 31 31 0 31 31 31 31 31 31 21 16 16 16 20 1 0 31 0 31 31 31 31 0 0 31 0 0 0 1 31 
0 31 31 31 31 1 31 31 0 31 31 31 31 0 0 31 21 16 16 16 20 31 0 31 31 31 0 31 0 0 0 31 0 0 31 31 31 
31 31 1 31 31 31 31 31 31 31 31 31 31 31 31 31 21 16 16 16 20 31 31 1 31 0 31 31 31 31 31 31 31 0 31 1 0 
0 31 31 31 31 1 31 31 31 31 0 0 31 31 31 31 21 16 16 16 20 0 0 0 31 31 0 31 31 31 31 31 31 31 31 31 31 
31 31 31 1 31 31 31 31 0 31 0 31 31 1 0 31 21 16 16 16 20 31 31 0 31 31 31 0 31 0 31 0 31 31 31 31 31 
31 0 31 31 31 31 31 31 0 31 0 0 31 31 31 31 21 16 16 16 20 31 0 31 31 31 31 0 31 0 31 0 31 31 31 0 0 
31 31 0 31 31 31 0 31 31 31 31 31 31 1 31 31 21 16 16 16 20 31 31 31 31 31 31 31 31 31 31 31 31 31 31 31 31 
0 0 0 31 31 31 31 0 31 31 31 0 31 31 31 31 21 16 16 16 20 1 31 31 31 0 31 0 0 31 31 31 0 31 31 31 31 
0 0 31 31 31 1 31 31 31 31 31 31 31 31 31 1 21 16 16 16 20 31 0 31 1 31 0 0 0 31 31 31 31 0 31 31 31 
31 31 31 31 31 31 31 31 31 1 31 0 31 31 31 31 21 16 16 16 20 0 0 31 31 31 31 0 31 31 1 31 31 31 31 1 31 
0 31 0 31 31 31 1 31 31 1 31 31 31 0 31 31 21 16 16 16 20 31 31 31 31 31 31 0 0 31 31 31 31 31 0 31 0 
31 0 31 31 31 0 31 31 31 31 31 31 1 31 31 31 21 16 16 16 20 31 1 31 31 0 31 31 31 31 31 31 31 31 31 31 31 
31 31 31 1 31 0 31 31 0 31 31 31 31 31 1 31 21 16 16 16 20 31 31 1 0 31 31 0 0 31 0 31 31 31 31 1 31 
0 31 31 31 31 0 31 31 0 31 0 31 31 31 31 0 21 16 16 16 20 31 31 1 31 0 31 31 31 31 31 31 0 31 0 31 31 
31 31 31 31 31 31 31 31 0 31 31 31 31 31 31 31 21 16 16 16 20 1 0 31 31 31 0 0 31 31 31 31 0 31 0 0 31 
31 0 0 31 0 0 31 31 0 31 31 31 31 0 31 31 21 16 16 16 20 0 31 0 0 31 0 0 31 31 31 0 31 0 31 31 0 
31 0 31 31 31 31 31 31 31 31 0 31 1 31 31 31 21 16 16 16 20 31 31 31 0 0 31 31 31 31 31 31 0 0 31 31 31 
31 0 31 0 31 31 31 31 0 31 31 31 31 0 31 0 21 16 16 16 20 31 31 31 0 31 31 31 0 31 31 31 31 31 31 0 31 
0 0 31 31 31 31 31 31 0 31 31 31 31 31 31 0 21 16 16 16 20 0 31 31 0 0 31 31 31 31 31 31 31 31 31 31 31 
31 31 31 31 31 0 31 0 0 31 31 1 31 0 31 31 21 16 16 16 20 31 31 31 31 31 31 31 1 31 31 31 31 0 31 31 31 
31 0 31 1 31 31 31 31 0 31 31 31 31 31 31 31 21 16 16 16 20 31 31 0 31 0 31 1 1 0 31 31 31 31 0 31 0 
31 31 31 31 31 31 31 31 31 31 31 0 31 31 0 31 21 16 16 16 20 1 31 31 31 0 31 31 31 31 31 1 31 31 31 0 31 
31 31 31 1 31 1 31 31 31 31 31 31 31 31 31 1 21 16 16 16 20 31 31 1 31 1 31 31 31 31 1 31 31 0 0 31 31 
31 0 31 31 31 31 31 31 0 31 31 0 31 31 0 1 27 18 18 18 28 1 31 31 31 31 31 0 31 31 31 1 31 31 31 31 31 
0 0 31 31 0 0 0 31 0 31 31 31 31 31 1 31 31 31 31 31 31 31 1 31 31 0 31 31 31 1 31 31 31 31 31 1 31 
