31 31 0 31 0 31 1 31 0 0 30 30 30 30 30 30 30 16 16 16 30 30 30 30 30 30 30 1 31 31 31 1 31 1 31 31 31 
31 31 31 0 0 31 1 0 0 31 30 30 30 30 30 30 30 16 16 16 30 30 30 30 30 30 30 31 0 31 0 31 0 31 31 31 0 
31 31 0 31 31 31 1 0 31 31 30 30 30 30 30 30 30 16 16 16 30 30 30 30 30 30 30 31 31 31 1 1 31 1 31 1 31 
31 31 31 1 31 31 1 0 31 31 30 30 30 30 30 30 30 16 16 16 30 30 30 30 30 30 30 31 1 31 31 31 1 31 31 1 31 
31 31 1 1 0 31 1 0 31 1 30 30 30 30 30 30 30 16 16 16 30 30 30 30 30 30 30 31 31 1 31 1 31 1 31 31 1 
31 1 31 1 1 1 1 31 31 31 30 30 30 30 30 30 30 16 16 16 30 30 30 30 30 30 30 31 31 31 1 1 31 31 1 1 31 
0 31 31 1 0 31 1 31 0 31 30 30 30 30 30 30 30 16 16 16 30 30 30 30 30 30 30 31 31 1 31 31 31 31 1 31 1 
0 31 31 1 31 0 31 31 31 31 30 30 30 30 30 30 30 16 16 16 30 30 30 30 30 30 30 31 1 1 31 31 1 31 31 1 4 
6 1 1 1 0 0 0 0 0 31 30 30 30 30 30 30 30 16 16 16 30 30 30 30 30 30 30 31 31 1 1 31 1 31 1 4 15 
8 31 31 1 0 0 31 0 0 1 30 30 30 30 30 30 30 16 16 16 30 30 30 30 30 30 30 31 31 31 31 1 1 31 31 7 2 
8 31 31 1 0 31 0 31 0 31 30 30 30 30 30 30 30 16 16 16 30 30 30 30 30 30 30 1 31 31 1 31 31 1 31 7 2 
11 31 31 1 31 31 0 1 0 31 30 30 30 30 30 30 30 16 16 16 30 30 30 30 30 30 30 31 31 31 1 31 1 31 1 7 2 
1 1 1 1 31 31 31 31 0 31 30 30 30 30 30 30 30 16 16 16 30 30 30 30 30 30 30 31 1 31 31 31 31 1 4 15 2 
31 0 31 1 1 1 1 1 0 1 30 30 30 30 30 30 30 16 16 16 30 30 30 30 30 30 30 1 31 1 1 1 31 31 9 13 2 
1 0 31 31 0 31 1 31 0 1 30 30 30 30 30 30 30 16 16 16 30 30 30 30 30 30 30 31 31 31 31 1 1 31 1 7 2 
1 0 31 31 31 1 1 31 0 31 30 30 30 30 30 30 30 16 16 16 30 30 30 30 30 30 30 31 1 1 31 31 31 1 1 7 2 
31 31 31 1 31 1 0 1 0 1 30 30 30 30 30 30 30 16 16 16 30 30 30 30 30 30 30 1 31 1 31 1 31 1 4 15 2 
31 31 31 1 1 1 31 0 0 31 30 30 30 30 30 30 30 16 16 16 30 30 30 30 30 30 30 31 31 1 31 1 1 4 2 2 2 
31 1 31 1 31 31 0 31 0 31 30 30 30 30 30 30 30 16 16 16 30 30 30 30 30 30 30 31 1 31 31 4 5 15 2 2 2 
1 1 1 1 31 31 0 0 0 31 30 30 30 30 30 30 30 16 16 16 30 30 30 30 30 30 30 31 31 31 31 7 2 2 2 2 2 
5 6 1 1 1 31 31 0 31 1 30 30 30 30 30 30 30 16 16 16 30 30 30 30 30 30 30 1 1 31 4 15 2 2 2 2 2 
2 14 5 6 1 31 31 0 0 31 30 30 30 30 30 30 30 16 16 16 30 30 30 30 30 30 30 31 31 31 7 2 2 2 2 2 2 
2 2 2 8 1 31 1 31 31 31 30 30 30 30 30 30 30 16 16 16 30 30 30 30 30 30 30 31 31 0 7 2 2 2 2 2 2 
2 2 2 8 1 31 31 31 31 1 30 30 30 30 30 30 30 16 16 16 30 30 30 30 30 30 30 31 1 4 15 2 2 2 2 2 2 
2 2 12 11 1 0 0 0 31 31 30 30 30 30 30 30 30 16 16 16 30 30 30 30 30 30 30 1 0 7 2 2 2 2 2 2 2 
2 2 8 1 1 31 31 1 31 31 30 30 30 30 30 30 30 16 16 16 30 30 30 30 30 30 30 1 0 7 2 2 2 2 2 2 2 
2 12 11 1 31 31 31 31 1 31 30 30 30 30 30 30 30 16 16 16 30 30 30 30 30 30 30 1 0 7 2 2 2 2 2 2 2 
2 8 1 1 1 1 31 31 31 31 30 30 30 30 30 30 30 16 16 16 30 30 30 30 30 30 30 31 4 15 2 2 2 2 2 2 2 
2 14 6 1 31 31 31 1 31 1 30 30 30 30 30 30 30 16 16 16 30 30 30 30 30 30 30 31 7 2 2 2 2 2 2 2 2 
2 2 8 1 31 31 0 31 31 1 30 30 30 30 30 30 30 16 16 16 30 30 30 30 30 30 30 1 7 2 2 2 2 2 2 2 2 
2 2 8 1 1 31 1 31 1 1 30 30 30 30 30 30 30 16 16 16 30 30 30 30 30 30 30 31 7 2 2 2 2 2 2 2 2 
2 2 8 1 1 1 31 31 1 31 30 30 30 30 30 30 30 16 16 16 30 30 30 30 30 30 30 31 7 2 2 2 2 2 2 2 2 
2 2 14 6 31 1 1 0 1 31 30 30 30 30 30 30 30 16 16 16 30 30 30 30 30 30 30 31 7 2 2 2 2 2 2 2 2 
2 2 2 14 6 31 31 0 31 31 30 30 30 30 30 30 30 16 16 16 30 30 30 30 30 30 30 1 7 2 2 2 2 2 2 2 2 
2 2 2 2 8 31 31 1 31 31 30 30 30 30 30 30 30 16 16 16 30 30 30 30 30 30 30 31 7 2 2 2 2 2 2 2 2 
2 2 2 2 14 6 31 31 31 31 30 30 30 30 30 30 30 16 16 16 30 30 30 30 30 30 30 31 7 2 2 2 2 2 2 2 2 
2 2 2 2 2 8 1 31 31 1 30 30 30 30 30 30 30 16 16 16 30 30 30 30 30 30 30 31 7 2 2 2 2 2 2 2 2 
2 2 2 2 2 8 1 31 31 31 30 30 30 30 30 30 30 16 16 16 30 30 30 30 30 30 30 1 7 2 2 2 2 2 2 2 2 
2 2 2 2 2 14 6 1 31 31 30 30 30 30 30 30 30 16 16 16 30 30 30 30 30 30 30 31 7 2 2 2 2 2 2 2 2 
2 2 2 2 2 2 14 6 1 31 30 30 30 30 30 30 30 16 16 16 30 30 30 30 30 30 30 1 7 2 2 2 2 2 2 2 2 
2 2 2 2 2 2 2 14 6 31 30 30 30 30 30 30 30 16 16 16 30 30 30 30 30 30 30 31 7 2 2 2 2 2 2 2 2 
2 2 2 2 2 2 2 12 11 1 30 30 30 30 30 30 30 16 16 16 30 30 30 30 30 30 30 31 7 2 2 2 2 2 2 2 2 
2 2 2 2 2 2 2 8 1 31 31 30 30 30 30 30 30 16 16 16 30 30 30 30 30 30 0 0 7 2 2 2 2 2 2 2 2 
2 2 2 2 2 2 2 8 1 31 1 31 30 30 30 30 30 16 16 16 30 30 30 30 30 31 1 4 15 2 2 2 2 2 2 2 2 
2 2 2 2 2 2 2 14 6 1 31 1 31 30 30 30 30 16 16 16 30 30 30 30 1 31 4 15 2 2 2 2 2 2 2 2 2 
2 2 2 2 2 2 2 2 2 6 31 31 31 31 30 30 30 16 16 16 30 30 30 31 1 31 7 2 2 2 2 2 2 2 2 2 2 
2 2 2 2 2 2 2 2 2 2 6 1 1 31 30 30 30 16 16 16 30 30 30 31 1 4 15 2 2 2 2 2 2 2 2 2 2 
2 2 2 2 2 2 2 2 2 2 14 5 6 1 1 30 30 16 16 16 30 30 31 1 4 15 2 2 2 2 2 2 2 2 2 2 2 
2 2 2 2 2 2 2 2 2 2 2 2 14 6 0 30 30 16 16 16 30 30 1 4 15 2 2 2 2 2 2 2 2 2 2 2 2 
2 2 2 2 2 2 2 2 2 2 2 2 2 14 6 30 30 16 16 16 30 30 4 15 2 2 2 2 2 2 2 2 2 2 2 2 2 
